79 42
34 3
3 4 9 10 14 14 0 5 10
2 3 3 1 2 6
10 5 20 
2 20 45 1
5 5 100 
5 6 2 3
20
0 0  0  0  0  0  0  0 0 0 0 0 0 0 0  0  0  0  0  0  0  0 0 0 0 0  0  0  0  0  0  0  0  0  0 0 0 0  0  0  0  0  0  0  0  0  0 0  0 0 0  0  0  0  0  0 0 0 0  0  0  0  0  0  0  0  0  0  0  0  0  0  0 0 0 0 0 0 0 
0 0  0  0  0  0  0  0 0 0 0 0 0 0 0  0  0  0  0  0  0  0 0 0 0 0  0  0  0  0  0  0  0  0  0 0 0 0  0  0  0  0  0  0  0  0  0 0  0 0 0  0  0  0  0  0 0 0 0  0  0  0  0  0  0  0  0  0  0  0  0  0  0 0 0 0 0 0 0 
0 0  0  0  0  0  0  0 0 0 0 0 0 0 0  0  0  0  0  0  0  0 0 0 0 0  0  0  0  0  0  0  0  0  0 0 0 0  0  0  0  0  0  0  0  0  0 0  0 0 0  0  0  0  0  0 0 0 0  0  0  0  16 0  0  0  0  0  0  0  0  0  0 0 0 0 0 0 0 
3 0  0  0  0  0  0  0 0 0 0 0 0 0 0  0  0  0  0  0  0  0 0 0 0 0  0  0  0  0  0  0  0  0  0 0 0 0  0  0  0  0  0  0  0  0  0 0  0 0 0  0  0  0  0  0 0 0 0  0  0  0  0  0  0  0  0  0  0  0  0  0  0 0 0 0 0 0 0 
6 0  0  0  0  0  0  0 0 0 0 0 0 0 0  0  0  0  0  0  0  0 0 0 0 0  0  0  0  0  0  0  0  0  0 0 0 0  0  0  0  0  0  0  0  0  0 0  0 0 0  0  0  0  0  0 0 0 0  0  0  0  0  0  0  0  0  0  0  0  0  0  0 0 0 0 0 0 0 
6 0  0  0  0  0  0  0 0 0 0 0 0 0 0  0  0  0  0  0  0  0 0 0 0 0  0  0  0  0  0  0  0  0  0 0 0 0  0  0  0  0  0  0  0  0  0 0  0 0 0  0  0  0  0  0 0 0 0  0  0  0  0  0  0  0  0  0  0  0  0  0  0 0 0 0 0 0 0 
6 0  0  0  0  0  0  0 0 0 0 0 0 0 0  0  0  0  0  0  0  0 0 0 0 0  0  0  0  0  0  0  0  0  0 0 0 0  0  0  0  0  0  0  0  0  0 0  0 0 0  0  0  0  0  0 0 0 0  0  0  16 0  16 0  0  0  0  0  0  0  0  0 0 0 0 0 0 0 
6 0  0  0  0  0  0  0 0 0 0 0 0 0 0  0  0  0  0  0  0  1 2 2 2 3  0  0  1  2  3  0  0  0  0 0 0 0  0  0  0  0  0  0  0  0  0 0  0 0 0  0  0  0  0  0 0 0 0  0  0  0  0  0  0  0  0  0  0  0  0  0  0 0 0 0 0 0 0 
6 0  0  0  0  0  0  0 0 0 0 0 0 0 0  0  0  0  0  0  0  4 5 5 5 17 2  2 18  5  6  0  0  0  0 0 0 0  0  0  0  0  0  0  0  0  0 0  0 0 0  0  0  0  0  0 0 0 0  0  0  0  0  0  0  0  0  0  0  0  0  0  0 0 0 0 0 0 0 
6 0  0  0  0  0  0  0 0 0 0 0 0 0 0  0  0  0  0  0  0  7 8 8 8 8  8  8  8  8  9  0 10 11 12 0 0 0  0  0  0  0  0  0  0  0  0 0  0 0 0  0  0  0  0  0 0 0 0  0  0  0  0  0  0  0  0  0  0  0  0  0  0 0 0 0 0 0 0 
6 0  31 30 30 33 0  0 0 0 0 0 0 0 0  0  0  0  0  0  0  0 0 0 0 0  0  0  0  0  0  0  0  0  0 0 0 0  0  0  0  0  0  0  0  0  0 0  0 0 0  0  0  0  0  0 0 0 0  0  16 0  16 0  16 0  0  0  0  0  0  0  0 0 0 0 0 0 0 
17 2 3  29 29 34 0  0 0 0 0 0 0 0 0  0  0  0  0  0  0  0 0 0 0 0  0  0  0  0  0  0  0  0  0 0 0 31 30 33 0  0  0  0  0  0  0 0  0 0 0  0  0  0  0  0 0 0 0  0  0  0  0  0  0  0  0  0  0  0  0  0  0 0 0 0 0 0 0 
5 19 0  0  0  0  0  0 0 0 0 0 0 0 0  0  0  0  0  0  0  0 0 0 0 0  0  0  0  0  0  0  0  0  0 0 1 3  29 34 0  0  0  0  0  0  0 0  0 0 0  0  0  0  0  0 0 0 0  0  0  0  0  0  0  0  0  0  0  0  0  0  0 0 0 0 0 0 0 
25 0 0  0  0  0  0  0 0 0 0 0 0 0 0  0  0  0  0  0  0  0 0 0 0 0  0  0  0  0  0  0  0  0  0 0 7 9  0  0  0  0  0  0  0  0  0 0  0 0 0  0  0  0  0  0 0 0 0  0  0  0  0  0  0  0  0  0  0  0  0  0  0 0 0 0 0 0 0 
6 0  0  0  0  0  0  0 0 0 0 0 0 0 0  0  0  0  0  0  0  0 0 0 0 0  0  0  0  0  0  0  0  0  0 0 0 0  0  0  0  31 30 30 32 0  0 0  0 0 0  0  0  0  0  0 0 0 0  0  0  0  0  0  0  0  0  0  0  0  0  0  0 0 0 0 0 0 0
6 0  0  0  0  0  0  0 0 0 0 0 0 0 0  0  31 30 30 30 0  0 0 0 0 0  0  0  0  0  0  0  0  0  0 0 0 0  0  0  10 11 11 11 11 12 0 0  0 0 0  0  16 0  0  0 0 0 0  16 0  16 0  16 0  16 0  0  0  0  0  0  0 0 0 0 0 0 0
6 0  0  0  0  0  0  0 0 0 0 0 0 0 0  10 11 11 11 11 12 0 0 0 0 0  0  0  0  0  0  0  0  0  0 0 0 35 30 33 0  0  0  0  0  0  0 0  0 0 0  0  0  0  0  0 0 0 0  0  0  0  0  0  0  0  0  0  0  0  0  0  0 0 0 0 0 0 0
6 0  0  0  0  0  0  0 0 0 0 0 0 0 0  0  0  0  0  0  0  0 0 0 0 0  0  0  0  0  0  0  0  0  0 0 0 36 29 34 0  0  0  0  0  0  0 0  0 0 0  0  0  0  0  0 0 0 0  0  0  0  0  0  0  0  0  0  0  0  0  0  0 0 0 0 0 0 0
6 0  0  0  0  0  0  0 0 0 0 0 0 0 0  0  0  0  0  0  0  0 0 0 0 31 30 30 30 30 30 30 30 30 0 0 0 0  0  0  0  0  0  0  0  0  0 0  0 0 0  0  0  0  0  0 0 0 0  0  0  0  0  0  0  0  0  0  0  0  0  0  0 0 0 0 0 0 0
6 0  0  0  0  0  0  0 0 0 0 0 0 0 0  0  0  0  0  0  0  0 0 0 0 10 11 11 11 11 11 11 11 12 0 0 0 0  0  0  0  0  0  0  0  0  0 0  0 0 0  0  0  0  0  0 0 0 0  0  0  0  0  0  0  0  0  0  0  0  0  0  0 0 0 0 0 0 0
6 0  0  0  0  0  0  0 0 0 0 0 0 0 0  0  0  0  0  0  0  0 0 0 0 0  0  0  0  0  0  0  0  0  0 0 0 0  0  0  0  0  0  0  0  0  0 0  0 0 0  0  0  0  0  0 0 0 0  0  0  0  0  0  0  0  0  0  0  0  0  0  0 0 0 0 0 0 0
6 0  0  0  0  0  0  0 0 0 0 0 0 0 0  0  0  0  0  0  0  0 0 0 0 0  0  0  0  0  0  0  0  0  0 0 0 31 30 30 30 30 30 32 0  0  0 0  0 0 0  0  0  0  0  0 0 0 0  0  0  0  0  0  0  0  0  0  0  0  0  0  0 0 0 0 0 0 0
6 0  0  0  0  0  0  1 2 2 2 2 2 2 3  0  0  0  0  0  0  0 0 0 0 0  0  0  0  0  0  0  0  0  0 0 0 10 11 11 11 11 11 12 0  0  0 0  0 0 0  0  0  0  0  0 0 0 0  0  0  0  0  0  0  0  0  0  0  0  0  0  0 0 0 0 0 0 0
6 0  0  0  0  0  0  4 5 5 5 5 5 5 6  0  0  0  0  0  0  0 0 0 0 0  0  0  0  0  0  0  0  0  0 0 0 0  0  0  0  0  0  0  0  0  0 0  0 0 0  0  0  0  0  0 0 0 0  0  0  0  0  0  0  0  0  0  0  0  0  0  0 0 0 0 0 0 0
6 0  0  0  0  0  0  7 8 8 8 8 8 8 9  0  0  0  0  0  0  0 0 0 0 0  0  0  0  0  0  0  0  0  0 0 0 0  0  0  0  0  0  0  0  0  0 0 0 31 30 30 33 0  0  1 2 2 2  2  2  3  0  0  0  0  0  0  0  0  0  0  0 0 0 0 0 0 0 
6 0  0  0  0  0  0  0 0 0 0 0 0 0 0  0  0  0  0  0  0  0 0 0 0 0  0  0  0  0  0  0  0  0  0 0 0 0  0  0  0  0  0  0  0  0  0 1  2 3 29 29 34 0  0  4 5 5 5  5  5  9  0  0  0  0  0  0  0  0  0  0  0 0 0 0 0 0 0 
6 0  0  0  0  0  0  0 0 0 0 0 0 0 0  0  0  0  0  0  0  0 0 0 0 0  0  0  0  0  0  0  0  0  0 0 0 0  0  0  0  0  0  0  0  0  0 4  5 6  0 0  0  0  0  4 5 5 5  5  19 0  0  0  0  0  0  0  0  0  0  0  0 0 0 0 0 0 0 
6 0  0  0  0  0  0  0 0 0 0 0 0 0 0  0  0  0  0  0  0  0 0 0 0 0  0  0  0  0  0  0  0  0  0 0 0 0  0  0  0  0  0  0  0  0  0 4  5 6  0 0  0  0  0  4 5 5 5  25 0  0  0  0  0  0  0  0  0  31 30 33 0 0 0 0 0 0 0 
6 0  0  0  0  0  0  0 0 0 0 0 0 0 0  0  0  0  0  0  0  0 0 0 0 0  0  0  0  0  0  0  0  0  0 0 0 0  0  0  0  0  0  0  0  0  0 4  5 6  0 0  0  0  0  7 8 8 8  9  0  0  10 11 11 11 11 11 11 12 29 34 0 0 0 0 0 0 0 
6 0  0  0  0  0  0  0 0 0 0 0 0 0 0  0  0  0  0  0  0  0 0 0 0 0  0  0  0  0  0  0  0  0  0 0 0 0  0  0  0  0  0  0  0  0  0 4  5 6  0 0  0  0  0  0 0 0 0  0  0  0  0  0  0  0  0  0  0  0  0  0  0 0 0 0 0 0 0 
6 0  0  0  0  0  0  0 0 0 0 0 0 0 0  0  0  0  0  0  0  0 0 0 0 0  0  0  0  0  0  0  0  0  0 0 0 0  0  0  0  0  0  0  0  0  0 4 23 6  0 0  0  0  0  0 0 0 0  0  0  0  0  0  0  0  0  0  0  0  0  0  0 0 0 0 0 0 0 
6 0  0  0  0  0  0  0 0 0 0 0 0 0 0  0  0  0  0  0  0  0 0 0 0 0  0  0  0  0  0  0  0  0  0 0 0 0  0  0  0  0  0  0  0  0  0 27 0 28 0 0  0  0  0  0 0 0 0  0  0  0  0  0  0  0  0  0  0  0  0  0  0 0 0 0 0 0 0 
6 0  0  0  0  0  0  0 0 0 0 0 0 0 0  0  31 30 30 30 32 0 0 0 0 0  31 30 30 30 30 30 30 32 0 0 0 0  0  0  0  0  0  0  0  0  0 14 0 15 0 0  0  0  0  0 0 0 0  0  0  0  0  0  0  0  0  0  0  0  0  0  0 0 0 0 0 0 0 
6 0  0  0  0  0  0  0 0 0 0 0 0 0 1  2  3  29 29 29 1  2 2 2 2 2  3  29 29 29 16 29 29 1  2 2 2 2  2  3  30 30 30 30 30 32 0 14 0 0  0 0  0  0  0  0 0 0 0  0  0  0  0  0  0  0  0  0  0  0  0  0  1 2 2 2 2 2 3 
6 0  0  0  0  0  0  0 0 0 0 0 0 0 4  5  6  0  0  0  4  5 5 5 5 5  6  0  0  0  0  0  0  7  5 5 5 5  5  6  29 29 29 29 29 13 0 14 0 0  0 0  0  0  0  0 0 0 0  0  31 30 33 0  0  0  0  0  0  0  0  0  7 8 8 8 8 8 9 
6 0  0  0  0  0  0  0 0 0 0 0 0 0 4  5  6  0  0  0  4  5 5 5 5 5  6  0  0  0  0  0  0  0  20 5 5 5 5  6  0  0  0  0  0  14 0 15 0 0  0 0  0  0  0  0 0 0 10 11 12 29 34 0  0  0  0  0  0  0  0  0  0 0 0 0 0 0 0 
17 2 2  2  2  2  3  0 0 0 1 2 2 2 18 5  6  0  0  0  4  5 5 5 5 5  6  0  0  0  0  0  0  0  0 26 5 5 5  6  0  0  0  0  0  14 0 0  0 1  2 11 11 11 12 0 0 0 0  0  0  0  0  0  0  0  0  0  0  0  0  0  0 0 0 0 0 0 0 
5 5  5  5  5  5  6  0 0 0 4 5 5 5 5  5  6  0  0  0  4  5 5 5 5 5  6  0  0  0  0  0  0  0  0  7 8 8 8  9  0  0  0  0  0  14 0 0  0 4 19 0  0  0  0  0 0 0 0  0  0  0  0  0  0  0  0  0  0  0  0  0  0 0 0 0 0 0 0
5 5  5  5  5  5  17 2 2 2 18 5 5 5 5 5  6  0  0  0  4  5 5 5 5 5  6  0  0  0  0  0  0  0  0 0 0 0  0  0  0  0  0  0  0  14 0 0  0 27 0 0  0  0  0  0 0 0 0  0  0  0  0 35 30 32  0  0  0  0  0  0  0 0 0 0 0 0 0
5 5  5  5  5  5  5  5 5 5 5 5 5 5 5  5  6  0  0  0  4  5 5 5 5 5  6  0  0  0  0  0  0  0  0 0 0 0  0  0  0  0  0  0  0  14 0 0  0 14 0 0  0  0  0  0 0 0 0  0  0  0  0 36 29  1  2 2   2  3  0  0  0 0 0 0 0 0 0 
5 5  5  5  5  5  5  5 5 5 5 5 5 5 5  5  6  0  0  0  4  5 5 5 5 5  6  0  0  0  0  0  0  0  0 0 0 0  0  0  0  0  0  0  0  21 2 2  2 22 0 0  0  0  0  0 0 0 0  0  0  0  0  0  0  4  5 5   5  6  0  0  0 0 0 0 0 0 0 
5 5  5  5  5  5  5  5 5 5 5 5 5 5 5  5  6  0  0  0  4  5 5 5 5 5  6  0  0  0  0  0  0  0  0 0 0 0  0  0  0  0  0  0  0  4  5 5  5 6  0 0  0  0  0  0 0 0 0  0  0  0  0  0  0  4  5 5   5  6  0  0  0 0 0 0 0 0 0 